11111111111111111111111111
10040001111100000111004011
10111101111101110111011011
10000000000000000000000011
10111101111101111011111011
10111101111101111011111011
10111101111101111011111011
60000000000000000000000006
10111101111101111011111011
10111101111101111011111011
10000000000101000000000011
10111101110101011011111011
10111101110101011011111011
10000000000000000000000011
10111101111101111011000011
10000001111100000011000011
11110111111155111111101011
10000111111155111111101011
10110111113333331111101011
10110111113333331111101011
10110111113333331111101011
10110111111111111111101011
10000001111100000111000011
10111101111101110111011011
10000000000000000000000011
10111101111101111011111011
10111101111101111011111011
10111101111101111011111011
60000000000000000000000006
10111101111101111011111011
10111101111101111011111011
10000000000101000000000011
10111101110101011011111011
10111101110101011011111011
10040000000000000000004011
10111101111101111011000011
10000001111100000011000011