1111111111111111111111111111
1004000000000110000000040001
1011110111110110111110111101
1019910199910110199910199101
1011110111110110111110111101
1000000000000000000000000001
1011110110111111110110111101
1011110110111111110110111101
1000000110000110000110000001
1111110111110110111110111111
9999910111110110111110199999
9999910110000000000110199999
9999910110111551110110199999
1111110110133333310110111111
6000000000133333310000000006
1111110110133333310110111111
9999910110111111110110199999
9999910110000000000110199999
9999910110111111110110199999
1111110110111111110110111111
1000000000000110000000000001
1011110111110110111110111101
1011110111110110111110111101
1000110000000000000000110001
1110110110111111110110110111
1110110110111111110110110111
1000400110000110000110004001
1011111111110110111111111101
1011111111110110111111111101
1000000000000000000000000001
1111111111111111111111111111